░░░╳░░░░░░░░╞╦═════╡░░░░░
░░░║░░░░░░░░░║░░░░░░╥░░░░
░░░║░░╔═════╡║░░░░░░║░░░░
░░░║░░║░░░░░░╠══════╩╗░░░
░░░║░░║░░░░░░║░░░░░╞═╩═╡░
░░░╚══╬░░░░░░║╞════╦════╗
░░░░░░╠══════╣░░░░░║░░░░║
░░░░░░3░░░░░░░░░░░░║░░░░║
░░╥░░░║░░░░░░░░░░░░║░░░░║
░░║░░░║░░░░╔═══╡░░░║░░░░║
░░║░░░║░░░░║░░░░░░░║░░░░║
░░╚═══╣░░░░╚╗░░░░░░║░░░░║
░░░░░░╠═════╬══════╩════╝
░░░░░░2░░░░░╨░░░░░░░░░░░░
░╥░░░░║░░░░░░░░░░╞═════╗░
░║░░░░║░░░░░░░░░░░░░░░░║░
░║░░░░║╔═══╗░░░░░░░░░░░║░
░╠═╡░░╠╬═══╬═══════╦═══╝░
░║░░░░╨║░░░║░░░░░░░║░░░░░
░║░░░░╞╝░░░║░░░░░░░║░░░░░
╔╝░░░░░░░░░║░░░░░░░╨░░░░░
╠══════════╣░░░░░░░░░░░░░
║░░░░░░░░░╔╩════╗░░░░░░░░
║░░░░░░░░╔╝░░░░╞╬╡░░░░░░░
╚════════╝░░░░░╞╩╡░░░░░░░
